OXXXXXXXXXXXXXXX
OOOXOOOXOOOOOOOX
XOOXOXOXOOOOOOOX
XOOXOXOXOOOOOOOX
XOOOOXOXOOOOOOOX
XOOOOXOOOOOOOOOX
XOOOOXOOOO*OOOOX
XOOOOXOOOOOOOOOX
XOOOOOOOOOOOOOOX
XOOOOOOOOOOOOOOX
XOOOOOXXXXOOOOOX
XOOOOOXOOOOOXOOX
XOXXXOXOOOOOXOOX
XOXOOOXOOOOOXOOX
XOXOXXXOOOOOXOOX
XXXXXXXXXXXXXXXX