OXXXXXXXXXXXXXXX
OOOXOOOXOOOO0OOX
XOOXOXOXOOOOOOOX
XOOXOXOXOOOOOOOX
XOOOOXOXOOOO.OOX
XOOOOXOOOOOO.OOX
XOOOOXOOOOOOOOOX
XOOOOXOOOOOOOOOX
XOOOOOOOOOOOOOOX
XOOOOOOO0OOOOOOX
XOOOOOXXXXOOOOOX
XOOOOOXOOOOOXOOX
XOXXXOXOOOOOXOOX
XOXOOOXOOOOOXOOX
XOXOXXXOOOOOXOOX
XXXXXXXXXXXXXXXX