XXXXXXXXOXXXXXXXX
XFFFFFFFOFFFFFFFX
XFXXXXXFXFXXXXXFX
XFFFFFFFOFFFFFFFX
XFXXFXXFXFXXFXXFX
XFFFFXXFOFXXFFFFX
XFXXFXXFXFXXFXXFX
XFFFFFFFOFFFFFFFX
XFXXXXXXXXXXXXXFX
XFFFFFFFFFFFFFFFX
XFXXXXXXXXXXXXXFX
XFFFFFFFOFFFFFFFX
XFXXFXXFXFXXFXXFX
XFXXFFFFOFFFFXXFX
XFXXFXXFXFXXFXXFX
XFFFFFFFOFFFFFFFX
XXXXXXXXXXXXXXXXX