OXXXXXXXXXXXXXXX
OOOXOOOXOOOOOOOX
XOOXOXOXOOOOOOOX
XOOXOXOXOOOOOOOX
XOOOOXOXOOOOOOOX
XOOOOXOOOOOOOOOX
XOOOOXOOOOOOOOOX
XOOOOXOOOOOOOOOX
XOOOOOOOOOOOOOOX
XOOOOOOOOOOOOOOX
XOOOOOOOOOOOOOOX
XOOOOOOOOOOOOOOX
XOOOOOOOOOOOOOOX
XOOOOOOOOOOOOOOX
XOOOOOOOOOOOOOOX
XXXXXXXXXXXXXXXX